1011000011001100101
0100101011011010110
1011010010100101001
0111101011000111010
1011101010110010101
0111010011001000000
1111111111111111111
0010101110110110110
0101000011010000001
1010101110101011110
0011010011110001011
1001001000111111010
1010110000110000101