1001001001
0010010001
0010101010
0001000100
0101010100
0101010101
0101010101
0001000100